r r r r r r r r r r r r r r r r r r r r r r r r r pe p p p p 
r r r r r r r r r r r r r r r r r r r r r r r r r pe p p p p 
r r r r r r r r r r r r r r r r r r r r r r r r r pe p p p p 
r r r r 0 r r r r r r r r 0 r r r 0 r r 0 r r r r pe p p p p 
r r r 0 0 0 r 0 0 r r 0 0 0 r r 0 0 r 0 0 r r r r pe p p p p 
r r 0 0 0 0 0 0 0 r r 0 0 0 0 0 0 0 0 0 0 r r r r pe p p p p 
r r r r 0 0 0 0 0 0 0 0 0 0 0 0 0 0 0 0 0 0 r r r pe p p p p 
r 0 r r 0 0 0 0 0 0 0 0 0 0 0 0 0 0 0 0 0 0 0 0 r pe p p p p 
r 0 0 0 0 0 0 0 0 0 0 0 0 0 0 0 0 0 0 0 0 0 0 r r pe p p p p 
r 0 0 0 0 0 0 0 0 0 0 0 0 0 0 0 0 0 0 0 0 0 0 0 r pe p p p p 
r 0 0 0 0 0 0 0 0 0 r r 0 0 0 0 0 0 0 0 0 0 0 r r pe p p p p 
r 0 0 0 0 0 0 0 0 r r r 0 0 0 0 0 0 0 0 0 0 0 0 r pe p p p p 
r 0 0 0 0 0 0 0 0 0 0 0 0 0 0 0 0 0 0 0 0 0 r 0 r pe p p p p 
r 0 r r r r r r 0 0 0 0 0 0 0 0 0 0 0 0 0 0 r r r pe p p p p 
r 0 0 r r r r 0 0 0 0 0 0 0 0 0 0 0 0 0 0 0 r r r pe p p p p 
r 0 0 0 0 0 0 0 0 0 0 0 0 0 0 0 0 0 0 0 0 0 r r r pe p p p p 
r 0 0 0 0 0 0 0 0 0 0 0 0 0 0 0 0 0 0 0 0 0 0 r r pe p p p p 
r 0 0 0 0 0 0 0 0 0 0 0 0 0 0 0 0 0 0 0 0 0 0 r r pe p p p p 
r 0 0 0 0 0 0 0 0 r 0 0 0 0 0 0 0 0 0 0 0 0 0 0 0 pe p p p p 
r 0 0 0 0 0 0 0 r r r 0 0 0 0 0 0 0 0 0 0 0 0 0 0 pe p p p p 
r 0 0 0 0 0 0 r r r r r 0 0 0 r r 0 0 0 0 0 0 0 0 pe p p p p 
r 0 0 0 0 0 0 r r r r r 0 0 0 r r 0 0 0 0 0 0 0 0 pe p p p p 
r 0 0 0 0 0 0 0 r r r 0 0 0 0 0 0 0 0 0 0 0 0 0 0 pe p p p p 
r 0 0 0 0 0 0 0 0 r 0 0 0 0 0 0 0 0 0 0 0 0 0 0 0 pe p p p p 
r 0 0 0 0 0 0 0 0 0 0 0 0 0 0 0 0 0 0 0 0 0 0 0 0 pe p p p p 
r 0 0 0 0 0 0 0 0 0 0 0 0 0 0 0 0 0 0 0 0 0 0 0 r pe p p p p 
r 0 0 0 0 0 0 0 0 0 0 0 0 0 0 0 0 0 0 0 0 0 0 r r pe p p p p 
r 0 0 0 0 0 0 0 0 0 0 0 0 0 0 0 0 0 0 0 0 r 0 r r pe p p p p 
r 0 0 0 0 0 0 r r 0 0 0 0 0 0 0 0 0 0 r r r r r r pe p p p p 
r 0 0 0 0 0 0 r r 0 0 0 0 0 0 0 0 0 r r 0 r r r r pe p p p p 
r 0 0 0 0 0 0 0 0 0 0 0 0 0 0 0 0 0 0 0 r r r 0 r pe p p p p 
r 0 0 0 0 0 0 0 0 0 0 0 0 0 0 0 0 0 0 0 0 0 r 0 0 pe p p p p 
r r 0 0 0 0 0 0 0 0 r r r 0 0 0 0 0 0 0 0 0 0 0 0 pe p p p p 
r r 0 0 0 0 0 0 0 r r r r r 0 0 0 0 0 0 0 0 0 0 0 pe p p p p 
r r 0 0 0 0 0 r r r r r r r r 0 0 0 0 0 0 0 0 0 0 pe p p p p 
r r r r r r r r r r r r r r r 0 0 0 0 0 0 0 0 0 0 pe p p p p 
