r r r r r r r r r r r r r r r r r r r r r r r r r pe c1 c1 c1 c1
r r r r r r r r r r r r r r r r r r r r r r r r r pe c1 l gp cp
r r r r r r r r r r r r r r r r r r r r r r r r r pe c1 l1 gp1 cr1
r r r r 0 r r r r r r r r 0 r r r 0 r r 0 r r r r pe p p p p
r r r 0 0 0 r 0 0 r r 0 0 0 r r 0 0 r 0 0 r r r r pe c c1 c1 c
r r 0 0 0 0 0 0 0 r r 0 0 0 0 0 0 0 0 0 0 r r r r pe c1 p p c1
r r r r 0 0 0 0 0 0 0 0 0 cr 0 0 0 0 0 0 0 0 r r r pe c1 p p c1
r 0 r r 0 0 0 0 0 0 0 0 0 0 0 0 0 cr 0 0 0 0 0 0 r pe c c1 c1 c
r 0 0 0 cr cr 0 0 0 0 0 0 0 0 0 0 0 0 0 0 0 0 0 r r pe p p p p
r 0 0 0 cr 0 0 0 0 0 0 0 0 0 0 0 0 0 0 0 0 g 0 0 r pe p p p p
r 0 0 0 0 0 0 0 0 0 r r 0 0 0 0 0 0 0 0 0 0 0 r r pe p p p p
r 0 0 0 0 0 0 0 0 r r r 0 0 0 g g 0 0 0 0 0 0 0 r pe p p p p
r 0 0 0 0 0 0 0 0 0 0 0 0 0 0 0 0 0 0 0 0 0 r 0 r pe p p p p
r 0 r r r r r r 0 0 0 0 0 0 0 0 0 0 0 0 0 0 r r r pe p p p p
r 0 0 r r r r 0 0 0 0 0 g 0 0 0 0 0 0 0 0 0 r r r pe p p p p
r 0 0 0 0 0 0 0 0 0 0 0 0 0 0 0 0 0 cr 0 0 0 r r r pe p p p p
r 0 0 0 0 0 0 0 0 0 0 0 0 0 0 0 0 0 0 0 0 0 0 r r pe p p p p
r 0 0 0 0 g 0 0 0 0 0 0 0 0 0 0 0 g g 0 0 0 0 r r pe p p p p
r 0 0 0 0 0 0 0 0 r 0 0 0 0 0 0 0 0 g 0 0 0 0 0 0 pe p p p p
r 0 0 0 g 0 0 0 r r r 0 0 0 0 0 0 0 0 0 0 0 0 0 0 pe p p p p
r 0 0 0 0 0 0 r r r r r 0 0 0 r r 0 0 0 0 0 0 0 0 pe p p p p
r 0 0 0 0 0 0 r r r r r 0 0 0 r r 0 0 0 0 0 0 0 0 pe p p p p
r 0 0 0 0 0 0 0 r r r 0 0 0 0 0 0 0 0 0 0 0 0 0 0 pe p p p p
r 0 0 0 0 0 0 0 0 r 0 0 0 g 0 0 0 0 0 0 0 0 0 0 0 pe p p p p
r 0 0 0 cr 0 0 cr 0 0 0 0 0 0 0 0 0 0 0 0 0 0 0 0 0 pe p p p p
r 0 0 0 0 0 0 0 0 0 0 g 0 0 0 0 0 0 cr 0 0 0 0 0 r pe p p p p
r 0 0 0 0 0 0 0 0 0 0 0 0 0 0 0 0 0 0 0 0 0 0 r r pe p p p p
r 0 0 0 cr 0 0 0 0 0 0 0 0 cr 0 0 0 0 0 0 0 r 0 r r pe p p p p
r 0 0 0 0 0 0 r r 0 0 0 0 0 0 0 0 0 0 r r r r r r pe p p p p
r 0 0 0 0 0 0 r r 0 0 0 0 0 0 0 0 0 r r 0 r r r r pe p p p p
r 0 0 cr 0 0 0 0 0 0 0 0 0 0 0 0 0 0 0 0 r r r 0 r pe p p p p
r 0 0 0 0 0 0 0 0 0 0 0 0 0 0 0 0 0 0 0 0 0 r 0 0 pe p p p p
r r 0 0 0 0 0 0 0 0 r r r 0 0 0 0 0 0 0 0 0 0 0 0 pe p p p p
r r 0 0 0 0 0 0 0 r r r r r 0 0 0 g 0 0 0 0 0 0 0 pe p p p p
r r 0 0 0 0 0 r r r r r r r r 0 0 0 0 0 0 0 0 0 0 pe p p p p
r r r r r r r r r r r r r r r 0 0 0 0 0 0 0 0 0 0 pe p p p p
